XXXXEXX
E   P E
X     X
XX F  X
XX    X
XX X  X
XXXXEXX
